142 178 1
142 179 1
142 180 1
142 181 1
142 182 1
142 183 1
142 184 1
142 185 1
142 186 1
142 187 1
142 188 1
142 189 1
142 190 1
142 191 1
142 192 1
142 193 1
142 194 1
142 195 1
142 196 1
142 197 1
142 198 1
142 199 1
142 200 1
142 201 1
142 202 1
142 203 1
142 204 1
142 205 1
142 206 1
