138.0 178 1
138.0 178 1
138.0 178 1
138.0 178 1
138.0 178 1
138.0 178 1
138.0 178 1
138.0 178 1
138.0 179 1
138.0 179 1
138.0 179 1
138.0 179 1
138.0 179 1
138.0 179 1
138.0 179 1
138.0 180 1
138.0 180 1
138.0 180 1
138.0 180 1
138.0 180 1
138.0 180 1
138.0 180 1
138.0 181 1
138.0 181 1
138.0 181 1
138.0 181 1
138.0 181 1
138.0 181 1
138.0 181 1
138.0 182 1
138.0 182 1
138.0 182 1
138.0 182 1
138.0 182 1
138.0 182 1
138.0 182 1
138.0 183 1
138.0 183 1
138.0 183 1
138.0 183 1
138.0 183 1
138.0 183 1
138.0 183 1
138.0 184 1
138.0 184 1
138.0 184 1
138.0 184 1
138.0 184 1
138.0 184 1
138.0 184 1
138.0 185 1
138.0 185 1
138.0 185 1
138.0 185 1
138.0 185 1
138.0 185 1
138.0 185 1
138.0 186 1
138.0 186 1
138.0 186 1
138.0 186 1
138.0 186 1
138.0 186 1
138.0 186 1
138.0 187 1
138.0 187 1
138.0 187 1
138.0 187 1
138.0 187 1
138.0 187 1
138.0 187 1
138.0 187 1
138.0 188 1
138.0 188 1
138.0 188 1
138.0 188 1
138.0 188 1
138.0 188 1
138.0 188 1
138.0 189 1
138.0 189 1
138.0 189 1
138.0 189 1
138.0 189 1
138.0 189 1
138.0 189 1
138.0 190 1
138.0 190 1
138.0 190 1
138.0 190 1
138.0 190 1
138.0 190 1
138.0 190 1
138.0 191 1
138.0 191 1
138.0 191 1
138.0 191 1
138.0 191 1
138.0 191 1
138.0 191 1
138.0 192 1
138.0 192 1
138.0 192 1
138.0 192 1
138.0 192 1
138.0 192 1
138.0 192 1
138.0 193 1
138.0 193 1
138.0 193 1
138.0 193 1
138.0 193 1
138.0 193 1
138.0 193 1
138.0 194 1
138.0 194 1
138.0 194 1
138.0 194 1
138.0 194 1
138.0 194 1
138.0 194 1
138.0 195 1
138.0 195 1
138.0 195 1
138.0 195 1
138.0 195 1
138.0 195 1
138.0 195 1
138.0 196 1
138.0 196 1
138.0 196 1
138.0 196 1
138.0 196 1
138.0 196 1
138.0 196 1
138.0 196 1
138.0 197 1
138.0 197 1
138.0 197 1
138.0 197 1
138.0 197 1
138.0 197 1
138.0 197 1
138.0 198 1
138.0 198 1
138.0 198 1
138.0 198 1
138.0 198 1
138.0 198 1
138.0 198 1
138.0 199 1
138.0 199 1
138.0 199 1
138.0 199 1
138.0 199 1
138.0 199 1
138.0 199 1
138.0 200 1
138.0 200 1
138.0 200 1
138.0 200 1
138.0 200 1
138.0 200 1
138.0 200 1
138.0 201 1
138.0 201 1
138.0 201 1
138.0 201 1
138.0 201 1
138.0 201 1
138.0 201 1
138.0 202 1
138.0 202 1
138.0 202 1
138.0 202 1
138.0 202 1
138.0 202 1
138.0 202 1
138.0 203 1
138.0 203 1
138.0 203 1
138.0 203 1
138.0 203 1
138.0 203 1
138.0 203 1
138.0 204 1
138.0 204 1
138.0 204 1
138.0 204 1
138.0 204 1
138.0 204 1
138.0 204 1
138.0 205 1
138.0 205 1
138.0 205 1
138.0 205 1
138.0 205 1
138.0 205 1
138.0 205 1
138.0 206 1
